#=Wall
A=Chibit
_______________________________________________________________________________


    ###### ## ####
    #   #   # #  #
    #     A #    #
    #   #   # #  #
        #     ####
    #   #   #
    #########

